subreddit,subscribers,users_here,topSubscribers,topUsersHere,topDifference
gis,23213,0.0040204449134519345,51,3,48
MapPorn,458807,0.004529212741959556,48,1,47
comics,909590,0.003199829556818502,47,4,43
statistics,53780,0.0025945838118852727,49,7,42
datasets,35728,0.002137644391465534,50,8,42
blog,16415731,2.833242759521173e-5,13,50,-37
science,18625208,0.0003144895427081174,5,35,-30
Music,16832091,0.00031366009699135706,12,36,-24
books,14491285,0.0002540391362914349,19,40,-21
gadgets,13426371,9.053526592328257e-5,27,48,-21
OldSchoolCool,12801377,0.000705336696833375,42,21,21
DIY,13647738,0.0001877819239523213,25,44,-19
InternetIsBeautiful,13115543,2.2512771287534583e-5,32,51,-19
personalfinance,12892012,0.0006307079150814655,41,22,19
IAmA,17938955,0.0004218022618504697,8,26,-18
EarthPorn,15205816,0.002949034977281722,18,5,13
Art,12768317,0.00038073459469929386,43,30,13
todayilearned,18742927,0.0015478022666566363,3,15,-12
askscience,15423915,0.0003867215560637891,17,28,-11
Documentaries,13063059,0.0001729546918220434,34,45,-11
worldnews,18652581,0.0016768530479481722,4,14,-10
movies,17505597,0.000944692337246018,10,20,-10
space,13790311,0.00031546188058137887,24,34,-10
Jokes,13561739,0.0013003527939972096,26,17,9
explainlikeimfive,15523458,0.0005194868497473771,16,24,-8
nosleep,12245383,0.0003130149804883227,45,37,8
LifeProTips,14060622,0.0003840246477094719,22,29,-7
UpliftingNews,13000652,0.00021208770954181066,35,42,-7
listentothis,12955628,0.00010058189363698486,40,47,-7
tifu,13230284,0.0004401759666591279,31,25,6
funny,19441590,0.0027819617902125142,1,6,-5
photoshopbattles,13108152,0.00028895885081383027,33,38,-5
dataisbeautiful,12997762,0.00035845809196315956,36,31,5
philosophy,12719888,7.458135776402936e-5,44,49,-5
videos,17697387,0.0017439158051318511,9,13,-4
Showerthoughts,14009405,0.0010878557611192932,23,19,4
nottheonion,13385791,0.0003531407053935326,28,32,-4
GetMotivated,12988377,0.0002224773149731776,37,41,-4
history,12969320,0.00020025449902033406,39,43,-4
pics,18575353,0.0021151691462483148,6,9,-3
gaming,18050984,0.0018951117886353602,7,10,-3
television,14476383,0.0005568231185570585,20,23,-3
mildlyinteresting,14220699,0.0011346351901815863,21,18,3
food,13240524,0.0003414802982969189,30,33,-3
gifs,16078039,0.0017573430703196151,14,12,2
sports,13296523,0.0003912519789719211,29,27,2
news,15991767,0.0015118783488186603,15,16,-1
Futurology,12981824,0.00028380267332062624,38,39,-1
AskReddit,19157078,0.004351393219859039,2,2,0
aww,17073794,0.0017955398420330462,11,11,0
creepy,12186350,0.0001428302930328636,46,46,0
